WWWWWWWWWWWWWWWWWWWWWWWWWWWWWWWW
W000000000000000000000000000000W
W00000000000WWWWWW0000000000000W
W00000000000W0000W0000000000000W
W0000000000000000W0000000000000W
W00000000000000WWW0000000000000W
W00000000000000W000000000000000W
W00000000000000W000000000000000W
W000000000000000000000000000000W
W00000000Z00000W000000000000000W
W000000WWWWWW0000WWWWW000000000W
W00000000000W0000W000W000000000W
W00000000000W0000W000W000000000W
W000000WWWWWW00M0W000W000000000W
W00000000000W0000W000W000000000W
W00000000000W0000W000W000000000W
W000000WWWWWW0000WWWWW000000000W
W0000000000000Z0000000000000000W
W00000000000wwwwww0000000000000W
W0000Z0000000000000000000000000W
W00wwwwww000000000000wwwwww0000W
W00000000000wwwwww0000000000000W
WP00000000000000000000000000000W
WWWWWWWWWWWWWWWWWWWWWWWWWWWWWWWW