WWWWWWWWWWWWWWWWWWWWWWWWWWWWWWWW
W000000000000000000000000000000W
W00W00000000000000000000G00W000W
W00WWWWW000WWWWWWWWWWWWWWWWW000W
W000000000000000000000000000000W
W000000000000000000000000000000W
W00W00000000000000000000G00W000W
W00WWWWW000WWWWWWWWWWWWWWWWW000W
W000000000000000000000000000000W
W000000000000000000000000000000W
W00W00000000000G00000000000W000W
W00WWWWW000WWwwwwwwwwwwWWWWW000W
W000000000000000000000000000000W
W000000000000000000000000000000W
W00W00000000000000G00000000W000W
W00WWWWW000WwwwwwwwwwwwWWWWW000W
W000000000000000000000000000000W
W000000000000000000000000000000W
W00W000000000000000000G0000W000W
W00WWWWW000WwwwwwwwwwwwWWWWW000W
W000000000000000000000000000000W
W000000000000000000000000000000W
WP00000000000000000000000000000W
WWwwwwwwwwwwwwwwwwwwwwwwwwwwwwWW