WWWWWW00000000WWWWWWWWWWWWWWWWWW
W000000000000000000000000000000W
W000000000000000000000000000000W
W0000wwwwww00000000M00000000000W
W0000000000000000000000wwwwww00W
W0000000000WW000000000000000000W
W000000000000000wwww00000000000W
W0000wwwww000000000000000000000W
W0000000000WW000000000000000000W
W0000000000000M0000wwwww0000000W
W000000000000000000000000000000W
W00000000wwwww00000000000000000W
W000000000000000000000000000000W
W000WW00000000000wwwww000000000W
W000000000000000000000000000000W
W0000000000WW000M0000wwwwwww000W
W00wwwww00000000000000000000000W
W000000000000000000000000000000W
W0000000000000wwwwwwww000000000W
W000000000000000000000000000000W
W00000000000000000000wwwwww0000W
W000000000000000000000000000000W
WP00000000000000000000000000000W
WWWWWW00000000WWWWWWWWWWWWWWWWWW