WWWWWWWWWWWWWWWWWWWWWWWWWWWWWWWW
W000000000000000000000000000000W
W000000000000000000000000000000W
W000000000000000000000000000000W
W000000000000000000000000000000W
W000000000000000000000000000000W
W000000000000Z00000000000000000W
Www00WWWWWWWWWWWWWWWWWWW0000wwwW
W000000000000000000000000000000W
W000000000000000000000000000000W
W0000000000000Z0000000000000000W
Www00WWWWWWWWWWWWWWWWWWW0000wwwW
W000000000000000000000000000000W
W000000000000000000000000000000W
W000000000000Z00000000000000000W
Www00WWWWWWWWWWWWWWWWWWW0000wwwW
W000000000000000000000000000000W
W000000000000000000000000000000W
W000000000000Z00000000000000000W
Www00WWWWWWWWWWWWWWWWWWW0000wwwW
W000000000000000000000000000000W
W000000000000000000000000000000W
WP00000000000000000000000000000W
WWwwwwwwwwwwwwwwwwwwwwwwwwwwwwWW