WWWWWWWWWWWWWWWWWWWWWWWWWWWWWW0W
W000000000000000000000000000000W
W000000000000000000000000000000W
W000000000000000000000000000000W
WW00000Z00000000000000Z0000000WW
W0000WWWWWWWWW000WWWWWWWWW00000W
W0000W0000000000000000000W00000W
W000W000000M00000000000000W0000W
WW00W000000000000000000000W000WW
W000W0000000000M0000000000W0000W
W000W000000000000000000000W0000W
W000W000000000000000000000W0000W
WW00WW000M000000000000000WW000WW
W0000WWWWWWWWWWWWWWWWWWWWW00000W
W000000000000000000000000000000W
W000000000000000000000000000000W
WW0000000000000000000000000000WW
W000000000000000000000000000000W
W000000000000000000000000000000W
W000000000000000000000000000000W
W000000000000000000000000000000W
W000000000000000000000000000000W
WP00000000000000000000000000000W
WWwwwwwwwwwwwwwwwwwwwwwwwwwwwwWW