WWWWWWWWWWWWWWWWWWWWWWWWWWWWWWWW
W000000000000000000000000000000W
W000000000000000000000000000000W
W000000000000000Z00000000000000W
W000000000000wwwwww000000000000W
W000000000000000000000000000000W
W000000000000000000000000000000W
W00000000000Z0000000Z0000000000W
W000000000wwwww00wwwww000000000W
W000000000000000000000000000000W
W000000000000000000000000000000W
W00000000000000Z000000000000000W
W00000wwwwwwwwwwwwwwwwwww000000W
W000000000000000000000000000000W
W000000000000000000000000000000W
W000000000000000000000000000000W
W000wwwwww000wwwwww000wwwwww000W
W000000000000000000000000000000W
W000000000000000000000000000000W
W000000000000000000000000000000W
W000000000www000000www000000000W
W000000000000000000000000000000W
WP00000000000000000000000000000W
WWwwwwwwwwwwwwwwwwwwwwwwwwwwwwWW