WWWWWWWWWWWWWWWWWWWWWWWWWWWWWWWW
W000000000000000000000000000000W
W000000000000000000000000000000W
W000000000000Z00000000000000000W
WwwwwwwwwwwwwwwwwwwwwwwwwwwwwwwW
W000000000000000000000000000000W
W000000000000000000000000000000W
W000000000000Z00000000000000000W
WwwwwwwwwwwwwwwwwwwwwwwwwwwwwwwW
W000000000000000000000000000000W
W000000000000000000000000000000W
W00000000000Z000000000000000000W
WwwwwwwwwwwwwwwwwwwwwwwwwwwwwwwW
W000000000000000000000000000000W
W000000000000000000000000000000W
W0000000000G0000000000000000000W
WwwwwwwwwwwwwwwwwwwwwwwwwwwwwwwW
W000000000000000000000000000000W
W000000000G00000000000000000000W
WwwwwwwwwwwwwwwwwwwwwwwwwwwwwwwW
W000000000000000000000000000000W
W000000000000000000000000000000W
WP00000000000000000000000000000W
WWwwwwwwwwwwwwwwwwwwwwwwwwwwwwWW