WWWWW0000000WWWWWWWW0000000WWWWW
W000000000000000000000000000000W
W000000000000000000000000000000W
W000000000000000000000000000000W
W0000W00W00W00W000000W00W00W000W
W0000W00W00W00W000000W00W00W000W
W0000WM0WM0WM0W000000WM0WM0W000W
W0000W00W00W00W000000W00W00W000W
W0000W00W00W00W000000W00W00W000W
W0000W00W00W00W000000W00W00W000W
W0000W00W00W00W000000W00W00W000W
W0000W00W00W00W000000W00W00W000W
W0000W00W00W00W000000W00W00W000W
W0000W00W00W00W000000W00W00W000W
W0000W00W00W00W000000W00W00W000W
W0000W00W00W00W000000W00W00W000W
W0000W00W00W00W000000W00W00W000W
W0000W00W00W00W000000W00W00W000W
W0000W00W00W00W000000W00W00W000W
W000000000000000000000000000000W
W000000000000000000000000000000W
W000000000000000000000000000000W
WP00000000000000000000000000000W
WWwww0000000wwwwwwww00000000wwWW